######################
####P ################
####  ###O############
####  X             O#
#O               #####
####   XX        #####
####  ##         #####
######################
