##################################
########       P    ##   # O    ##
##############     ### ### #  #  #
########    #####  ###  #  ##    #
#######  X########      #  ##    #
#######   ##        #     ##### ##
#######          #  #  #         #
############  ### ### ###  ##    #
#################     ############
##################################
